25
0 0
24 24
.........................
..................#......
..................#......
..................#......
###################......
.........................
.........................
....#####################
....#....................
....#.....###............
....###.....#............
....#.......#...######...
............#............
....#########............
....#....................
....#....................
....#....................
....#.....###############
....#.....#..............
....#.....#..............
....#.....#......#.......
....#.....#......#.......
....#.....#......#.......
....#............#.......
....#............#.......
