10
0 9
9 0
..........
..........
..........
######....
..........
..########
..........
####......
..........
..........