10
0 2
9 8
#........#
##.......#
##......##
##...##.##
..........
....##..#.
...#......
...#..####
#..#......
#..#......