10
0 0
9 9
..........
.....#....
......#...
.......#..
.......#..
.#.....#..
..#...#...
...###....
..........
..........